##### CATEGORIA SIMBOLOS GLOBALES ####
PPD: Punctuation Period
PCN: Punctuation Colon
PCA: Punctuation Comma
PSC: Punctuation Semicolon
  EEO: Expression Exclamation Open
EEC: Expression Exclamation Close
EQO: Expression Question Open
EQC: Expression Question Close
  MPS: Mathematical Plus
MMS: Mathematical Minus
MTS: Mathematical Times
MMO: Mathematical Modulus
MEQ: Mathematical Equals
MGR: Mathematical Greater
MLR: Mathematical Lesser
MDN: Mathematical Division
  GPO: Grouping Parenthesis Open
GPC: Grouping Parenthesis Close
GCO: Grouping Curly Bracket Open
GCC: Grouping XCurly Bracket Close
GBO: Grouping Bracket Open
GBC: Grouping Bracket Close
  OBS: Other Back Slash
OAA: Other Arroba
ONS: Other Number Symbol
ODS: Other Dollar Sign
OHO: Other Carret
ONP: Other Ampersand
OVD: Other Pipe


FILE files/default_3.txt AWL 4 AWPS inf AWPP 4 ADPP 0 ACPP 0 ACOPP 0 ASCPP 0 AQPP 0 AMQPP 0 AWSPS 0.75 AK1 0 AK2 0 AK3 0 AWS 0 ACAS 0 ACBS 0 